"الإندبندنت": توزيع جوائز الأوسكار وسط إجراءات أمنية مشددة
لندن -  ا ش أ
 ذكرت صحيفة "الاندبندنت" البريطانية الاثنين 25 فبراير، انه قد انتهت فعاليات حفل توزيع جوائز الأكاديمية الأمريكية للعلوم والفنون "الأوسكار" بنسختها الخامسة والثمانين، في هوليوود.
 و حصل من خلالها فيلم "أرجو" على جائزة أفضل فيلم، كما حصل النجم دانيال داى لويس، على جائزة أفضل ممثل، فيما نالت الممثلة جينيفر لورانس على جائزة أفضل ممثلة.
وأشارت الصحيفة في تقرير أوردته على موقعها الالكتروني إلى أن شرطة مدينة لوس أنجلوس الامريكية قامت بتشديد الإجراءات الأمنية خلال حفل توزيع جوائز الأوسكار في أعقاب موجة العنف المسلح في الولايات المتحدة.
وأعلنت الشرطة أنها دائما تتوخى الحذر خلال مراسم الحفل إلا انه وردت تقارير قبل بدء الحفل تقترح تشديد الاجراءات الأمنية عن المعتاد في أعقاب حادثة إطلاق نار مدرسة "ساندي هوك" الابتدائية إلى جانب حادثة ضابط الشرطة السابق كريستوفر دورنر، المتهم بقتل ثلاثة أشخاص .
وأوردت الصحيفة القائمة الكاملة للفائزين بـ"الأوسكار" لعام 2013:
* جائزة أفضل فيلم: "آرجو"
* جائزة أفضل ممثلة: جينيفر لورانس عن دورها في فيلم "سيلفر لينينجز بلاى بوك"
* جائزة أفضل ممثل: دانيال داى لويس عن دوره في فيلم "لينكولن".
* جائزة أفضل مخرج: أنج لي عن فيلم "حياة باى".
* جائزة أفضل ممثل مساعد: كريستوفر فالتز عن دوره فى فيلم "ديجانجو انتشيند".
* جائزة أفضل ممثلة مساعدة: آن هاثاواى عن دورها فى فيلم "البؤساء".
* جائزة أفضل فيلم رسوم متحركة: "بريف" "شجاعة"
* جائزة أفضل سيناريو مقتبس: "آرجو"
* جائزة أفضل سيناريو أصلى: "ديانجو انتشيند"
* جائزة أفضل تصوير سينمائي : "حياة باي".
* جائزة أفضل تصميم أزياء: "آنا كارنينا"
* جائزة أفضل فيلم وثائقي طويل:"سيرشينج فور شوجر مان"
* جائزة أفضل فيلم وثائقي قصير: "بريء"
* جائزة أفضل مونتاج : "آرجو"
* جائزة أفضل ماكياج: "البؤساء"
* جائزة أفضل أغنية أصلية: فيلم "سكاي فول"
* جائزة أفضل موسيقى تصويرية أصلية: فيلم "لايف أوف باى"
* جائزة أفضل مونتاج صوت: "زيرو دارك ثيرتى" و"سكايفال".
* جائزة أفضل تصميم إنتاج: "لينكولن".
* جائزة أفضل فيلم رسوم متحركة قصير: "بيبرمان".
* جائزة أفضل فيلم حركة قصير: "كيرفيو""حظر التجول".
* جائزة أفضل مزج صوتى: "البؤساء".
* جائزة أفضل مؤثرات بصرية: "حياة باى"